Bernalillo County - Albuquerque
Catron County - Reserve
Chaves County - Roswell
Cibola County - Grants
Colfax County - Raton
Curry County - Clovis
De Baca County - Fort Sumner
Do√±a Ana County - Las Cruces
Eddy County - Carlsbad
Grant County - Silver City
Guadalupe County - Santa Rosa
Harding County - Mosquero
Hidalgo County - Lordsburg
Lea County - Lovington
Lincoln County - Carrizozo
Los Alamos County - Los Alamos
Luna County - Deming
McKinley County - Gallup
Mora County - Mora
Otero County - Alamogordo
Quay County - Tucumcari
Rio Arriba County - Tierra Amarilla
Roosevelt County - Portales
San Juan County - Aztec
San Miguel County - Las Vegas
Sandoval County - Bernalillo
Santa Fe County - Santa Fe
Sierra County - Truth or Consequences
Socorro County - Socorro
Taos County - Taos
Torrance County - Estancia
Union County - Clayton
Valencia County - Los Lunas