Baker County - Baker City
Benton County - Corvallis
Clackamas County - Oregon City
Clatsop County - Astoria
Columbia County - St. Helens
Coos County - Coquille
Crook County - Prineville
Curry County - Gold Beach
Deschutes County - Bend
Douglas County - Roseburg
Gilliam County - Condon
Grant County - Canyon City
Harney County - Burns
Hood River County - Hood River
Jackson County - Medford
Jefferson County - Madras
Josephine County - Grants Pass
Klamath County - Klamath Falls
Lake County - Lakeview
Lane County - Eugene
Lincoln County - Newport
Linn County - Albany
Malheur County - Vale
Marion County - Salem
Morrow County - Heppner
Multnomah County - Portland
Polk County - Dallas
Sherman County - Moro
Tillamook County - Tillamook
Umatilla County - Pendleton
Union County - La Grande
Wallowa County - Enterprise
Wasco County - The Dalles
Washington County - Hillsboro
Wheeler County - Fossil
Yamhill County - McMinnville