Anderson County - Palestine
Andrews County - Andrews
Angelina County - Lufkin
Aransas County - Rockport
Archer County - Archer City
Armstrong County - Claude
Atascosa County - Jourdanton
Austin County - Bellville
Bailey County - Muleshoe
Bandera County - Bandera
Bastrop County - Bastrop
Baylor County - Seymour
Bee County - Beeville
Bell County - Belton
Bexar County - San Antonio
Blanco County - Johnson City
Borden County - Gail
Bosque County - Meridian
Bowie County - Boston
Brazoria County - Angleton
Brazos County - Bryan
Brewster County - Alpine
Briscoe County - Silverton
Brooks County - Falfurrias
Brown County - Brownwood
Burleson County - Caldwell
Burnet County - Burnet
Caldwell County - Lockhart
Calhoun County - Port Lavaca
Callahan County - Baird
Cameron County - Brownsville
Camp County - Pittsburg
Carson County - Panhandle
Cass County - Linden
Castro County - Dimmitt
Chambers County - Anahuac
Cherokee County - Rusk
Childress County - Childress
Clay County - Henrietta
Cochran County - Morton
Coke County - Robert Lee
Coleman County - Coleman
Collin County - McKinney
Collingsworth County - Wellington
Colorado County - Columbus
Comal County - New Braunfels
Comanche County - Comanche
Concho County - Paint Rock
Cooke County - Gainesville
Coryell County - Gatesville
Cottle County - Paducah
Crane County - Crane
Crockett County - Ozona
Crosby County - Crosbyton
Culberson County - Van Horn
Dallam County - Dalhart
Dallas County - Dallas
Dawson County - Lamesa
Deaf Smith County - Hereford
Delta County - Cooper
Denton County - Denton
DeWitt County - Cuero
Dickens County - Dickens
Dimmit County - Carrizo Springs
Donley County - Clarendon
Duval County - San Diego
Eastland County - Eastland
Ector County - Odessa
Edwards County - Rocksprings
El Paso County - El Paso
Ellis County - Waxahachie
Erath County - Stephenville
Falls County - Marlin
Fannin County - Bonham
Fayette County - La Grange
Fisher County - Roby
Floyd County - Floydada
Foard County - Crowell
Fort Bend County - Richmond
Franklin County - Mount Vernon
Freestone County - Fairfield
Frio County - Pearsall
Gaines County - Seminole
Galveston County - Galveston
Garza County - Post
Gillespie County - Fredericksburg
Glasscock County - Garden City
Goliad County - Goliad
Gonzales County - Gonzales
Gray County - Pampa
Grayson County - Sherman
Gregg County - Longview
Grimes County - Anderson
Guadalupe County - Seguin
Hale County - Plainview
Hall County - Memphis
Hamilton County - Hamilton
Hansford County - Spearman
Hardeman County - Quanah
Hardin County - Kountze
Harris County - Houston
Harrison County - Marshall
Hartley County - Channing
Haskell County - Haskell
Hays County - San Marcos
Hemphill County - Canadian
Henderson County - Athens
Hidalgo County - Edinburg
Hill County - Hillsboro
Hockley County - Levelland
Hood County - Granbury
Hopkins County - Sulphur Springs
Houston County - Crockett
Howard County - Big Spring
Hudspeth County - Sierra Blanca
Hunt County - Greenville
Hutchinson County - Stinnett
Irion County - Mertzon
Jack County - Jacksboro
Jackson County - Edna
Jasper County - Jasper
Jeff Davis County - Fort Davis
Jefferson County - Beaumont
Jim Hogg County - Hebbronville
Jim Wells County - Alice
Johnson County - Cleburne
Jones County - Anson
Karnes County - Karnes City
Kaufman County - Kaufman
Kendall County - Boerne
Kenedy County - Sarita
Kent County - Jayton
Kerr County - Kerrville
Kimble County - Junction
King County - Guthrie
Kinney County - Brackettville
Kleberg County - Kingsville
Knox County - Benjamin
La Salle County - Cotulla
Lamar County - Paris
Lamb County - Littlefield
Lampasas County - Lampasas
Lavaca County - Hallettsville
Lee County - Giddings
Leon County - Centerville
Liberty County - Liberty
Limestone County - Groesbeck
Lipscomb County - Lipscomb
Live Oak County - George West
Llano County - Llano
Loving County - Mentone
Lubbock County - Lubbock
Lynn County - Tahoka
Madison County - Madisonville
Marion County - Jefferson
Martin County - Stanton
Mason County - Mason
Matagorda County - Bay City
Maverick County - Eagle Pass
McCulloch County - Brady
McLennan County - Waco
McMullen County - Tilden
Medina County - Hondo
Menard County - Menard
Midland County - Midland
Milam County - Cameron
Mills County - Goldthwaite
Mitchell County - Colorado City
Montague County - Montague
Montgomery County - Conroe
Moore County - Dumas
Morris County - Daingerfield
Motley County - Matador
Nacogdoches County - Nacogdoches
Navarro County - Corsicana
Newton County - Newton
Nolan County - Sweetwater
Nueces County - Corpus Christi
Ochiltree County - Perryton
Oldham County - Vega
Orange County - Orange
Palo Pinto County - Palo Pinto
Panola County - Carthage
Parker County - Weatherford
Parmer County - Farwell
Pecos County - Fort Stockton
Polk County - Livingston
Potter County - Amarillo
Presidio County - Marfa
Rains County - Emory
Randall County - Canyon
Reagan County - Big Lake
Real County - Leakey
Red River County - Clarksville
Reeves County - Pecos
Refugio County - Refugio
Roberts County - Miami
Robertson County - Franklin
Rockwall County - Rockwall
Runnels County - Ballinger
Rusk County - Henderson
Sabine County - Hemphill
San Augustine County - San Augustine
San Jacinto County - Coldspring
San Patricio County - Sinton
San Saba County - San Saba
Schleicher County - Eldorado
Scurry County - Snyder
Shackelford County - Albany
Shelby County - Center
Sherman County - Stratford
Smith County - Tyler
Somervell County - Glen Rose
Starr County - Rio Grande City
Stephens County - Breckenridge
Sterling County - Sterling City
Stonewall County - Aspermont
Sutton County - Sonora
Swisher County - Tulia
Tarrant County - Fort Worth
Taylor County - Abilene
Terrell County - Sanderson
Terry County - Brownfield
Throckmorton County - Throckmorton
Titus County - Mount Pleasant
Tom Green County - San Angelo
Travis County - Austin
Trinity County - Groveton
Tyler County - Woodville
Upshur County - Gilmer
Upton County - Rankin
Uvalde County - Uvalde
Val Verde County - Del Rio
Van Zandt County - Canton
Victoria County - Victoria
Walker County - Huntsville
Waller County - Hempstead
Ward County - Monahans
Washington County - Brenham
Webb County - Laredo
Wharton County - Wharton
Wheeler County - Wheeler
Wichita County - Wichita Falls
Wilbarger County - Vernon
Willacy County - Raymondville
Williamson County - Georgetown
Wilson County - Floresville
Winkler County - Kermit
Wise County - Decatur
Wood County - Quitman
Yoakum County - Plains
Young County - Graham
Zapata County - Zapata
Zavala County - Crystal City