Accomack County – Accomac
Albemarle County – Charlottesville
Alexandria County - Alexandria
Alleghany County – Covington
Amelia County – Amelia Court House
Amherst County – Amherst
Appomattox County – Appomattox
Arlington County – Arlington
Augusta County – Staunton
Bath County – Warm Springs
Bedford County – Bedford
Bland County – Bland
Botetourt County – Fincastle
Bristol County - Bristol
Brunswick County – Lawrenceville
Buchanan County – Grundy
Buckingham County – Buckingham
Buena Vista County - Buena Vista
Campbell County – Rustburg
Caroline County – Bowling Green
Carroll County – Hillsville
Charles City County – Charles City
Charlotte County – Charlotte Courthouse
Charlottesville County - Charlottesville
Chesapeake County - Chesapeake
Chesterfield County – Chesterfield
Clarke County – Berryville
Clifton Forge County - Clifton Forge
Colonial Heights County - Colonial Heights
Covington County - Covington
Craig County – New Castle
Culpeper County – Culpeper
Cumberland County – Cumberland
Danville County - Danville
Dickenson County – Clintwood
Dinwiddie County – Dinwiddie
Essex County – Tappahannock
Fairfax County – Fairfax
Falls Church County - Falls Church
Fauquier County – Warrenton
Floyd County – Floyd
Fluvanna County – Palmyra
Franklin County – Rocky Mount
Franklin City County - Franklin
Frederick County – Winchester
Fredericksburg County - Fredericksburg
Galax County - Galax
Giles County – Pearisburg
Gloucester County – Gloucester
Goochland County – Goochland
Grayson County – Independence
Greene County – Stanardsville
Greensville County – Emporia
Halifax County – Halifax
Hampton County - Hampton
Hanover County – Hanover Courthouse
Henrico County – Richmond
Henry County – Martinsville
Highland County – Monterey
Hopewell County - Hopewell
Isle of Wight County – Isle of Wight
James City County – Williamsburg
King & Queen County – King and Queen Court House
King George County – King George
King William County – King William
Lancaster County – Lancaster
Lee County – Jonesville
Loudoun County – Leesburg
Louisa County – Louisa
Lunenburg County – Lunenburg
Lynchburg County - Lynchburg
Madison County – Madison
Manassas Park County - Manassas Park
Martinsville County - Martinsville
Mathews County – Mathews
Mecklenburg County – Boydton
Middlesex County – Saluda
Montgomery County – Christiansburg
Nelson County – Lovingston
New Kent County – New Kent
Newport News County - Newport News
Norfolk County - Norfolk
Norton County - Norton
Northampton County – Eastville
Northumberland County – Heathsville
Nottoway County – Nottoway
Orange County – Orange
Page County – Luray
Patrick County – Stuart
Petersburg County - Petersburg
Pittsylvania County – Chatham
Poquoson County - Poquoson
Portsmouth County - Portsmouth
Powhatan County – Powhatan
Prince Edward County – Farmville
Prince George County – Prince George
Prince William County – Manassas
Pulaski County – Pulaski
Radford County - Radford
Rappahannock County – Washington
Richmond County – Warsaw
Richmond City County - Richmond
Roanoke County – Salem
Roanoke City County - Roanoke
Rockbridge County – Lexington
Rockingham County – Harrisonburg
Russell County – Lebanon
Salem County - Salem
Scott County – Gate City
Shenandoah County – Woodstock
Smyth County – Marion
Southampton County – Courtland
Spotsylvania County – Spotsylvania Courthouse
Stafford County – Stafford
Staunton County - Staunton
Suffolk County - Suffolk
Surry County – Surry
Sussex County – Sussex
Tazewell County – Tazewell
Virginia Beach County - Virginia Beach
Warren County – Front Royal
Washington County – Abingdon
Waynesboro County - Waynesboro
Westmoreland County – Montross
Williamsburg County - Williamsburg
Winchester County - Winchester
Wise County – Wise
Wythe County – Wytheville
York County – Yorktown