Adams County - Ritzville
Asotin County - Asotin
Benton County - Prosser
Chelan County - Wenatchee
Clallam County - Port Angeles
Clark County - Vancouver
Columbia County - Dayton
Cowlitz County - Kelso
Douglas County - Waterville
Ferry County - Republic
Franklin County - Pasco
Garfield County - Pomeroy
Grant County - Ephrata
Grays Harbor County - Montesano
Island County - Coupeville
Jefferson County - Port Townsend
King County - Seattle
Kitsap County - Port Orchard
Kittitas County - Ellensburg
Klickitat County - Goldendale
Lewis County - Chehalis
Lincoln County - Davenport
Mason County - Shelton
Okanogan County - Okanogan
Pacific County - South Bend
Pend Oreille County - Newport
Pierce County - Tacoma
San Juan County - Friday Harbor
Skagit County - Mount Vernon
Skamania County - Stevenson
Snohomish County - Everett
Spokane County - Spokane
Stevens County - Colville
Thurston County - Olympia
Wahkiakum County - Cathlamet
Walla Walla County - Walla Walla
Whatcom County - Bellingham
Whitman County - Colfax
Yakima County - Yakima